R 1280 960

NO ./textures/blue.xpm


SO ./textures/brick.xpm
WE ./textures/grey.xpm
EA    ./textures/wood.xpm

S ./textures/barrel.xpm

C 28,179,255
F 150,150,150

111111111111111111111111111111111111111
100E00000000000000000000000000000000011
10000000000000000000000000000000000001111111
100000000111111111111111111111111111111111
1000000001
1000000001
1000000001
1000000001
1110011111
1110011111111111
1110011111
1110011111
1000000001
1000000001
1000000001
1000000001
1000000001
1000000001
1000000001
1000000001
1000000001
1000000001
1000000001
1000000001
1000000001
1002200001
1000000001
1020000001
1000220001
1000000001
1000000001
1111111111